1111111111111111
1111111111111111
11............11
11............11
11....2234.5..11
11......3.....11
11.....0...0..11
11............11
11............11
11............11
1111111111111111
1111111111111111